{"title":"SAT Study Words 826 to 850"}
Nullify	to counter; make unimportant
Apocryphal	of doubtful origin
Pragmatic	practical
Amorphous	lacking in shape
Meander	wander from side to side
Rescind	retract; repeal
Libertarian	someone who opposes tyranny
Usurp	take someone's position (usually by force)
Apprehensive	worried; fearful
Beleaguer	besiege; attack
Utopian	a believer in an ideal world
Arbitrary	random; for no definite reason
Balk	hinder and prevent; hesitate over
Abhor	hate
Veracity	truthfulness
Benevolent	kindly
Soporific	inducing sleep
Ire	anger [irate (a) = very angry]
Ignominy	shame [ignominious (a) = shameful]
Castigate	scold strongly
Gullibility	unwariness; trustfulness; being easily fooled
Plethora	an excess
Prodigious	very large
Undermined	damaged; attacked
Wistful	melancholy; pensive; expressing a longing for