{"title":"SAT Study Words 601 to 700"}
Histrionic	theatrical; exaggerated
Meager	in short supply
Deference	respect
Revere	worship
Creditable	praiseworthy
Candor	frankness; openness
Recuperate	get better after illness
Apathy	lack of interest or emotion
Plagiarism	taking credit for someone else's writing or ideas
Catharsis	purging of pent-up emotions
Instigator	troublemaker; person who entices others to do something
Volatile	dangerously unstable; evaporates easily
Precipice	steep slope
Pretentious	pompous; self-important
Goad	prod; urge
Aesthetic	concerning art or beauty
Caldron	huge cooking pot
Intransigent	stubborn; unyielding
Precedent	a previous occurrence used as a guide
Transient	short-lived; ephemeral
Remorse	regret; sorrow; contrition
Metaphorically	symbolically; figuratively
Denounce	condemn; speak out against
Omniscient	all-knowing
Malady	illness
Talisman	lucky charm
Euphemism	a polite phrase to cover something unpleasant
Zany	crazy; wacky
Dike	dam; embankment
Antediluvian	outdated; prehistoric; very old-fashioned
Lofty	snooty; arrogant; haughty
Complacent	self-satisfied; smug
Anthology	a book which is a collection of poems or stories
Salutary	something which teaches you a lesson; beneficial
Confound	confuse
Laceration	a cut
Quaint	picturesque
Poseur	someone who puts on an act
Traverse	to move across
Exemplary	outstandingly good; setting a fine example
Capacious	spacious
Gratis	free of charge; without payment
Liniment	soothing lotion
Derogatory	uncomplimentary
Drawl	speak slowly with words running together
Celerity	speed
Thwart	prevent; frustrate
Preclude	prevent or make impossible
Seminary	an institution in which priests are trained
Blasphemy	speech which offends religious sentiments
Red tape	formalities; paperwork; official procedure
Boorish	ill-mannered
Hiatus	interruption; pause
Superlative	extremely good; the best
Debunking	exposing false claims or myths
Uproarious	hilarious; hysterical; very funny
Milieu	environment
Collate	arrange in order
Ossify	1. turn to bone; 2. become fixed and rigid
Anarchy	chaos; lack of government
Momentous	very important
Titter	giggle quietly
Wax	to increase; to grow
Pliable	flexible; not stubborn
Blunderbuss	1. ancient weapon (type of gun); 2. a clumsy person
Dispassionate	neutral; objective
Dilemma	puzzling situation
Expedite	make faster
Surreptitiously	secretly; furtively; stealthily
Bard	poet
Conundrum	a puzzle
Laud	praise
Analgesic	medicine to combat pain
Emerge	come out; appear
Recluse	someone who cuts himself off from life
Gregarious	extroverted; sociable; outgoing
Arable	can be cultivated
Luscious	juicy; moist; succulent
Diligent	hard-working
Circuitous	indirect
Malefactor	a wrong-doer
Broach	start to discuss; approach
Sycophant	bootlicker; flatterer
Garish	gaudy
Coercion	force
Bane	troublesome influence
Parody	a mockery; imitation for ridicule; spoof
Tenacious	stubborn; resolute; holding firm to a purpose
Dogmatic	having stubbornly held opinions
Longevity	long life
Vivify	enliven
Terse	concise; to the point
Pedant	person who insists on strict adherence to rules or narrow learning
Parasite	1. scrounger; 2. animal which takes digested food from another
Collage	picture made from fragments of other pictures
Frivolous	not serious
Wary	hesitant; cautious
Bemoan	complain about
Referendum	public vote
Philanthropy	charity; love of mankind