{"title":"SAT Study Words 401 to 500"}
Posthumous	after death
Pejorative	derogatory
Impious	wicked; profane
Pristine	unspoiled
Presentiment	a feeling that something might happen
Salubrious	health-giving
Hamper	hinder; obstruct
Clamor	shout; scream
Masochist	person who intentionally inflicts pain on himself
Bourgeois	middle class
Pertinent	relevant
Misnomer	wrong name
Sluggard	slow-moving; lethargic person
Hasten	hurry; accelerate; rush
Sophomoric	juvenile; immature
Restorative	a tonic
Moribund	on the point of death
Flout	defy; reject
Potable	suitable for drinking
Ascetic	without luxuries; severely simple
Impartial	unbiased; neutral
Livid	very angry
Hoary	old
Contrition	sorrow and repentance
Amelioration	improvement
Bellicose	war-like; aggressive
Largess	generosity
Inclination	tendency; a leaning toward
Pervasive	spreading everywhere
Hieroglyphics	1. picture writing; 2. writing which is difficult to read or enigmatic
Servile	overly submissive; groveling
Vivacity	liveliness; animation
Blatant	obvious
Astute	perceptive; sharp-witted
Opaque	does not let light through
Demur	hesitate; refuse
Resignation	acceptance of fate
Immutable	unchanging; permanent
Effusive	gushing; demonstrative
Obscured	hidden; covered; buried
Unfetter	set free
Protagonist	main character in film, book, play etc.
Redress	put right something that was wrong
Prosody	study of versification
Renown	fame
Epistolary	concerned with letters; through correspondence
Receptacle	container; vessel; holder
Absolution	forgiveness; pardon; release
Depravity	moral corruption
Panacea	remedy for all ills
Deplore	regret
Censorious	disapproving; critical
Poignant	deeply moving; strongly affecting the emotions
Fly-by-night	unreliable; disreputable
Proponents	promoters; supporters
Colloquial	local and informal (used of language)
Parched	dried up
Mitigate	lessen; make less severe
Defoliate	cause leaves to fall off
Peerless	without equal
Perceptive	observant
Dichotomy	a division into two parts
Fanaticism	passion; excessive devotion
Ironic	satiric; unexpected
Quirk	oddity
Cynical	believing that people act only out of selfish motives
Mendacious	given to lying
Peripatetic	nomadic; moving from place to place
Phlegmatic	calm; imperturbable
Emancipate	set free
Belie	contradict
Exemplify	to serve as a good example
Abstruse	difficult to understand; obscure
Indelible	cannot be wiped out
Conspicuous	easily seen; prominent
Vacuous	empty; silly; meaningless
Gibbering	making meaningless noises
Lax	careless; not strict
Persnickety	fastidious; fussy
Disinterested	unbiased
Illusory	deceptive; false; misleading
Decorum	dignified, correct behavior [decorous (a)]
Pusillanimous	cowardly
Monotonous	dull; unvarying
Raucous	rough and unpleasant (of sounds)
Underscore	emphasize
Callow	immature
Nettle	annoy
Levity	flippancy; joking about serious matters
Fortuitous	happening by chance
Provincial	unsophisticated; narrow-minded
Chicanery	trickery
Nonchalance	an appearance of indifference; calm and composed
Kindle	to start a fire
Condone	tacitly support; overlook
Circumscribe	limit
Specious	false
Jurisprudence	science or study of law
Anthropocentrism	putting man at the center of one's philosophy
Beret	type of cap