{"title":"SAT Study Words 301 to 325"}
Flagrant	clearly wrong
Marsupial	pouched mammal (like a kangaroo)
Concatenate	link together
Edifice	building; structure; construction
Lavish	on a grand scale; wasteful
Surly	grumpy; rude
Pyromania	compulsion to start fires
Invidious	arousing envy
Contrite	sorry
Cower	recoil in fear or servility; shrink away from
Chastises	punishes
Nonentity	a person of no importance; not famous
Variegated	multicolored; speckled
Stoic	known for fortitude; indifferent to pleasure or pain
Proletarian	member of the working class
Contusion	a bruise
Wispy	flimsy; frail; delicate
Flaunt	show off; display in a showy manner
Patron	one who give support (usually financial)
Palliative	a remedy that improves but doesn't cure
Dexterous	skilful with hands
Negligence	carelessness
Maverick	a loner
Consecrate	dedicate
Amity	friendship